GGGGGGGGGGGGGGGGGGG
GGGGGGGGCSGGGGGGGGG
GGSSSSSSSSSSSSSSSSS
GSSGGGGGSSGGGGGGGGG
SSGGGGGGGSGGGGGGGGG
GGGGGGGGGSGGGGGGGGG
GGGGGGGGGSGGGGGGGGG
GGGGGGGGGSGGGGGGGGG
GGGGGGGGGSGGGGGGGGG
GGGGGGGGGSGGGGGGGGG
