WFFMMFFGGGGGFFGGGGWFFFFFGG
WWMMMFFGGGGFFFGGGGWWFFFFGG
GGWMMFFFGGDDDMDDDGGGWFFFGG
GWFFFFFFFDDDLLDDDFFWFFFFGG
GGWFFFFFFMDLSLSLDMFFWFFFGG
GWGGGGGFDDSLLLLSDDFWFFFFGG
GGWWGGGGDLSLLLLLSLDGWWFFGG
GGFWWGGGDLLLVVLLLDGGWWFFGG
GGFFWGGFDLSLLLLLSLGGGGWFGG
GGFWFFFDDDSLLLLSDFGGGWFFGG
GGFFWFFFMDDLLSLLMFFFFFWFGG
GGFWGGFFDDDDDDDDFFFFFWFFGG
GGFFWWGGGDDDMDDDGGFFMMWWGG
GGFFFWWGGGFFFGGGGFFMMMFWGG
GGFFFFFWGGGFFGGGGGFFMMFWGG
SSSSSSSWSSSSSSSSSSSSSSSWSS