WWWWWWWWWWWWWWWWSGWFDDDGGG
WMMFFFFFFFFFMMWSGWWFDDDGGG
GWMFFFFFFFFFFMWSGWMWFDDGGG
GWFFFFFFFFFFFWGGWMMWFDDGGG
GGWFFFLLLLFFFWGDWFFFWFDGGG
GGWFFLLLLLFFWDDWFFFFWFDGGG
GGGWFLLVVLLFWDDWFFFFFWFGGG
GGGWFLLLLLFWDDWFLLLLFWFGGG
GGGFWFLLLLFWDDWFLLLLLFWGGG
GGGFWFFFFFWDDWFLLVVLLFWGGG
GGGDFWFFFFWDDWFFLLLLLFFWGG
GGGDFWFFFWDGWFFFLLLLFFFWGG
GGGDDFWMMWGGWFFFFFFFFFFFWG
GGGDDFWMWGSWMFFFFFFFFFFMWG
GGGDDDFWWGSWMMFFFFFFFFFMMW
GGGDDDFWGSWWWWWWWWWWWWWWWW