FFFGGFFFFFFFGFFFGGGGFFFFFF
GGFGGGFFGFFFFFFFFGFFFFFFFF
FFFFFFFFGFFFFFFGFFFGFFFFFF
FFFFFGGFGFGFFFFGGFFFFGFFFF
GGFFGFFFFFGFFFGFGFFFGGFFFF
FFGGFFFFFFFGFFFFFFFFFFFFFF
GGGFFGGFFFGFFFGFGFFFGFFFFF
FFFGFFFFFFFFFFFFGFFFFGGFFF
FFGGFFFFFFFFFGFFFFFFFFGFFF
FFFFGFFFFFGGFFFFGFFFFFFFFF
FFFFFGGFFFFGFFFFFFFFFFFFFF
FFFFFFFFFFFFFFFGGFFFFFFFFF
FFFFFFFGFFFFGFFFFFFFFFFFFF
FFFFGFFFFFGFFFFFFFFFFFFFFF
FFFFGFFFFFFFFGFFFFFFFFFFFF
FFFFFFFFFFFFFFFFFFFFFFFFFF